1111111111111111111111
100100P0000000000000C1
100C0CCCCC111110111111
1C00111110C00C101010C1
10101CCC10010010000001
1000110010010000000011
100001C110000CCCCC00C1
1000C000100000000111C1
1C0E00CC00000111111111
100010CCC0000C11000011
1111111111111111111111
